10 10
---
1 1 1 1 1 1 1 1 1
1 1 1 1 1 1 1 1 1
1 1 1 1 1 1 1 1 1
1 1 1 1 1 1 1 1 1
1 1 1 1 1 1 1 1 1
1 1 1 1 1 1 1 1 1
1 1 1 1 1 1 1 1 1
1 1 1 1 1 1 1 1 1
1 1 1 1 1 1 1 1 1
---
3 1 8 0 0 10 0 0 0
0 1 0 0 0 0 1 0 1
0 10 0 0 0 0 10 0 15
0 0 0 0 0 0 0 1 1
1 0 1 1 1 0 1 0 0
0 0 10 0 1 12 0 10 0
0 0 1 12 1 0 0 0 12
0 0 1 0 0 10 1 1 0
1 0 1 0 0 0 0 0 9
---
