10 10
---
1 1 1 1 1 1 1 1 1
1 1 1 1 1 1 1 1 1
1 1 1 1 1 1 1 1 1
1 1 1 1 1 1 1 1 1
1 1 1 1 1 1 1 1 1
1 1 1 1 1 1 1 1 1
1 1 1 1 1 1 1 1 1
1 1 1 1 1 1 1 1 1
1 1 1 1 1 1 1 1 1
---
3 0 8 0 0 0 0 0 15
0 0 0 10 0 0 0 1 1
0 1 1 1 0 1 0 1 9
0 0 0 0 0 1 0 1 12
0 1 1 1 1 1 0 1 0
0 1 0 0 0 0 0 0 10
1 1 1 1 1 0 1 1 0
0 0 0 0 0 0 0 1 0
1 1 1 1 0 10 0 10 0
---
