5 5
---
1 1 1 1
1 1 1 1 1
1 1 1 1 1
1 1 1 1 1
1 1 1 1 1
---
0 0 1 0 0
0 0 1 5 0
3 0 4 0 0
0 0 1 6 0
0 0 1 0 0
---
