5 5
---
1 1 1 1 1
1 1 1 1 1
1 1 1 1 1
1 1 1 1 1
1 1 1 1 1
---
0 0 1 0 0
0 3 1 0 0
0 0 10 0 0
0 8 1 6 0
0 0 1 0 0
---
